####################################
#                                  #
#                                  #
#         P                        # 
#                                  #
#                       X          #
#                                  #
#                                  #      
#                        O         #
#                                  #
####################################
